####################
#A-----------------#
#------------------#
#------------------#
#------------------#
#------------------#
#------------------#
#------------------#
#------------------#
#------------------#
#---------P--------G
#------------------#
#------------------#
#------------------#
#------------------#
#--------------O---#
#------------------#
#------------------#
#------------------#
##########G#########
