####################
#------------------#
#------------------#
#------------------#
#------------------#
#------------------#
#------------------#
#------------------#
#------------------#
#------------------#
G------------------#
#------------------#
#------------------#
#------------------#
#------------------#
#------------------#
#------------------#
#------------------#
#------------------#
##########G#########
