##########G#########
#------------------#
#------------------#
#------------------#
#------------------#
#------------------#
#------------------#
#------------------#
#------------------#
#------------------#
G------------------#
#------------------#
#------------------#
#------------------#
#------------------#
#------------------#
#------------------#
#------------------#
#------------------#
####################
